56,56,57,57,57,57,57,56,57,57,57,57,57,57,57,57,57,57,57,57
56,56,57,57,57,57,57,56,57,57,57,57,57,57,57,57,57,57,57,57
56,56,57,57,57,57,57,56,57,57,57,57,57,57,57,57,57,57,57,57
56,56,57,57,57,57,57,56,57,57,57,57,57,57,57,57,57,57,57,57
56,56,57,57,57,56,56,56,57,57,56,56,56,57,57,57,56,56,56,56
56,56,57,57,56,56,56,56,57,57,56,56,56,56,57,57,56,56,56,56
56,56,57,57,56,56,56,56,57,57,56,56,56,56,57,57,56,56,56,56
56,56,57,57,56,57,57,57,57,57,56,57,57,57,57,57,56,57,57,57
56,56,57,57,56,57,57,57,57,57,56,57,57,57,57,57,56,57,57,57
56,56,56,56,56,56,56,56,56,56,56,56,56,56,56,56,56,56,56,56
56,56,56,56,56,56,56,56,56,56,56,56,56,56,56,56,56,56,56,56
56,56,56,56,56,56,56,56,56,56,56,56,56,56,56,56,56,56,56,56
56,56,56,56,56,56,56,56,56,56,56,56,56,56,56,56,56,56,56,56
56,56,56,56,56,56,56,56,56,56,56,56,56,56,56,56,56,56,56,56
56,56,56,56,56,56,56,56,56,56,56,56,56,56,56,56,56,56,56,56
56,56,57,57,57,57,57,57,57,57,57,57,57,57,57,57,57,57,57,57
56,56,57,57,57,57,57,57,57,57,57,57,57,57,57,57,57,57,57,57
56,56,57,57,57,57,57,57,57,57,57,57,57,57,57,57,57,57,57,57
56,56,57,57,57,57,57,57,57,57,57,57,57,57,57,57,57,57,57,57
56,56,57,57,57,57,57,57,57,57,57,57,57,57,57,57,57,57,57,57
