1596,1597,3385,3385,3385,3385,3385,3506,3385,3385,3385,3385,3385,3385,3385,3385,3385,3385,3385,3385
1596,1597,3385,3385,3385,3385,3385,3385,3385,3385,3385,3385,3385,3385,3385,3385,3385,3385,3385,3385
1596,1597,3385,3385,3385,3385,3385,3385,3385,3385,3385,3385,3385,3385,3385,3385,3385,3385,3385,3385
1596,1597,3385,3385,3385,3385,3385,3385,3385,3385,3385,3385,3385,3385,3385,3385,3385,3385,3385,3385
1596,1597,1774,1774,1774,1774,1774,1774,1774,1774,1774,1774,1774,1774,1774,1774,1774,1774,1774,1774
1596,1597,1774,1774,1774,1774,1774,1774,1774,1774,1774,1774,1774,1774,1774,1774,1774,1774,1774,1774
1597,1774,1774,1774,1774,1774,1774,1774,1774,1774,1774,1774,1774,1774,1774,1774,1774,1774,1774,1774
1597,1774,1774,1774,1774,1774,1774,1774,1774,1774,1774,1774,1774,1774,1774,1774,1774,1774,1774,1774
1596,1596,1597,1774,1774,1774,1774,1774,1774,1774,1774,1774,1774,1774,1774,1774,1774,1774,1774,1774
1596,1597,1774,1774,1774,1774,1774,1774,1774,1774,1774,1774,1774,1774,1774,1774,1774,1774,1774,1774
1774,1774,1774,1774,1774,1774,1774,1774,1774,1774,1774,1774,1774,1774,1774,1774,1774,1774,1774,1774
1774,1774,1774,1774,1774,1774,1774,1774,1774,1774,1774,1774,1774,1774,1774,1774,1774,1774,1774,1774
1774,1774,1774,1774,1774,1774,1774,1774,1774,1774,1774,1774,1774,1774,1774,1774,1774,1774,1774,1774
1774,1774,1774,1774,1774,1774,1774,1774,1774,1774,1774,1774,1774,1774,1774,1774,1774,1774,1774,1774
1774,1774,1774,1774,1774,1774,1774,1774,1774,1774,1774,1774,1774,1774,1774,1774,1774,1774,1774,1774
1596,1597,1412,1412,1412,1412,1412,1412,1412,1412,1412,1412,1412,1412,1412,1412,1412,1412,1412,1412
1596,1597,1412,1412,1412,1412,1412,1412,1412,1412,1412,1412,1412,1412,1412,1412,1412,1412,1412,1412
1596,1597,1412,1412,1412,1412,1412,1412,1412,1412,1412,1412,1412,1412,1412,1412,1412,1412,1412,1412
1596,1597,1412,1412,1412,1412,1412,1412,1412,1412,1412,1412,1412,1412,1412,1412,1412,1412,1412,1412
1596,1597,1412,1412,1412,1412,1412,1412,1412,1412,1412,1412,1412,1412,1412,1412,1412,1412,1412,1412
